actor1	actor2
AMIS, SUZY	FAY, MEAGEN
TUPPER, REG	GORANSON, LINDA
ANDERSON, LISA ARRINDELL	TOPOR, JOHN
NAUGHTON, JAMES	BISUTTI, DANIELLE
WEISMAN, KEVIN	ROYER, SHARLENE
CHEADLE, DON	NUTTALL, JEFF
ANDERSON, PAMELA (I)	SZIBLER, STEPHEN
GAULT, WILLIE	MIDDLETON, KATHRIN
SMITH, ANNA DEAVERE	COX, EDWARD R.
WRIGHT, SARAH (VII)	GATI, KATHLEEN
REED, LOU	SMITH, ANNA DEAVERE
BEATTY, WARREN (I)	MIKO, IZABELLA
COLEMAN, GARY (I)	BROWN, ERIN (XI)
HANSSON, JOHN (II)	HAAGA, TRENT
LAHTI, CHRISTINE (I)	MIXON, KATY
BASTONI, STEVE	LEE, TOMMY (VI)
TREMBLETT, KEN	DONOVAN, ELISA
CARMACK, CHRIS	CUNNINGHAM, JOHN (I)
HOWARD, SETH	RYAN, MITCHELL (II)
FAULKNER, JAMES (I)	MYA (I)
MANTEGNA, GIA	PODHORA, ROMAN
FOSTER, NEIL (I)	MCCOMB, HEATHER (I)
STRAUSS, PETER (I)	MORGAN, WAYNE DOUGLAS
KEYS, ALICIA	PHILLIPS, LOU DIAMOND
SHIPMAN, WILLIAM	KADISH, CHRISTOPHER
ARNOLD, TOM (I)	SMITH, ROGER CRAIG
MARTIN, BRAD (I)	HAIDUC, ION
QUINLAN, MAEVE	RENFRO, BRAD
RISPOLI, MICHAEL	HARRY, DEBORAH (I)
HAYNES, JERRY	DUPUY, LOUIS
ADDABBO, ANTHONY	PRESSLY, JAIME
BARNBROOK, JACQUIE	CORLEY, ANNIE
DONELLA, CHAD	COX, BRIAN (I)
HAWK, TONY	NYKL, DAVID
DUFFY, KAREN (I)	WEAVER, SIGOURNEY
FOX, COLIN (I)	BOS, JAN (I)
NUÒEZ, CHRIS (II)	TERAJIMA, SUSUMU
PAGONES, THEO NICHOLAS	SCRIBNER, DON
SARTAIN, GAILARD	IRWIN, BILL (I)
LEAL, SHARON (I)	MINA, MINA E.
CLARK, MATT (I)	SHINKODA, PETER
RAMIS, HAROLD	RAYMONDE, TANIA
KEIFFER, DENNIS	KB, FORBES
ROBERTS, SEAN O.	DELAMA, NEIL
BYRD, STEVEN RAY	CHAN, LUNG
RIVAS, GEOFFREY	CAMP, BILL (I)
CHAMPEAU, ISABELLE	BLEVINS, RONNIE GENE
GAINES, BOYD	HEMSWORTH, CHRIS
EVERMORE, J.D.	PEÒA, MICHAEL
BASS, LANCE	SCORZELLI, MICHALINA
NEWELL, DOUGLAS	MULLANY, TERRY
TOCHI, BRIAN	MCCUE, DAVID DALE
LEWIS, DAVID (IV)	STAITE, JEWEL
HENLEY, BARRY SHABAKA	GARCÌA BERNAL, GAEL
FERNANDEZ, ALEX (I)	CORSAIR, BILL
DAVIS, ESSIE	JONES, RICHARD T. (I)
FELTON, TOM	DELL, CHARLIE (I)
KELLY, JAMES MARTIN	ARGENZIANO, CARMEN
WILMOT, DAVID (I)	DEW, MARTIN
LINDE, BETTY	BOSWALL, JOHN
NYMAN, ANDY	FERRIN, NICK
LAMBERT, BRENT (II)	SHANDLING, GARRY
HANKS, COLIN	SHEARER, HARRY
DAMON, UNA	VINOT, M. JEARL
SCHAEFER, JOSHUA	LOWE, JOHN B. (I)
RADECKI, BARBARA	PROCTER, EMILY (I)
COOK, ROSS P. (II)	MORGAN, TRACY (II)
MCDOWELL, MALCOLM	WYN DAVIES, GERAINT
ROBERTS, IAN (II)	EDWARDS, ERIC (I)
MCCABE-LOKOS, MAXWELL	BANKS, LINDEN
PROSKY, ROBERT	BERTRAND, JACOB
LANGELLA, FRANK	ALEXANDER, JANE (I)
MATHESON, HANS	DRUMMOND, ALICE
GAINSBOURG, CHARLOTTE	LURIE, EVAN
KLEIN, ASHLEY (II)	SPAHIU, GABRIEL (I)
VALENTINE, GARY (I)	HUDSON, PETER (I)
HOLLOWAY, JOSH (I)	HOSTETTER, JOHN
DILLARD, RICHARD (I)	SAGE, BILL (I)
DICENZO, GEORGE	PRATHER, RON
YOUNG, VICTOR A.	FREEMAN, ALFONSO
LOUISO, TODD	AARONS, BONNIE
FRIEDMAN, ANDREW (IV)	ZURER, AYELET
TSAROUCHAS, ANGELO	TRAVIS, GREG (I)
WYANT, TIMOTHY	O'TOOLE, PETER (I)
CLARK, SPENCER TREAT	SNYDER, JOHN (I)
PORIZKOVA, PAULINA	CLEMENTS, KYLE RUSSELL
CREED-MILES, CHARLIE	LAFLEUR, ART
JUDD, ASHLEY	ROONEY, TED (I)
REYNOLDSON, RONDEL	ROSS, MATT (I)
MCGINLEY, TED	LAUTER, ED
MOLL, RICHARD	LAVELL, MARK (I)
WAITES, THOMAS G.	FRIEDERICY, BONITA
VINCENT, FRANK (I)	JIBSON, MICHAEL
HANNIGAN, ALYSON	JAMES, RODNEY L.
JENSEN, ASHLEY (I)	HADER, BILL
REYNOLDS, BURT (I)	WYLIE, ADAM
HAEUSER, RUSSELL M.	BEAVER, JIM (I)
WUHL, ROBERT	MACDONALD, JOHN (I)
DOHERTY, SHANNEN	DORVAL, ADRIEN
DE MARE, VICTORIA	PAPE, DANNY
GUILLORY, SIENNA	DAVIS, BRIANNE
STAITE, JEWEL	SKRABANEK, WILLIAM VICTOR
PLUMMER, AMANDA	FRITZ, NIKKI
MELLO, TAMARA	REAGAN, RONALD (I)
BOEVING, CHRISTIAN	KHAN, A.J. (I)
LEVY, HOPE	YEAGER, BIFF (I)
YAKUSHO, KÙJI	RALPH, JAMES (I)
FLORESCU, CONSTANTIN	UNGER, DEBORAH KARA
CONLEY, JACK (I)	OSBORNE, HOLMES
MORA, DANNY	TODD, ANTONIO LEWIS
GANDERTON, MONIQUE	NICHOLSON, JULIANNE
CHIN, WELLSON	WILLIAMS, COLLEEN (I)
YOUNG, SHELBY (I)	CARTLIDGE, KATRIN
LEBRUN, JUSTIN	DEVLIN, ALAN
O'BYRNE, KEHLI	RANDAZZO, KATHLEEN
VAN HOUTEN, CARICE	FOREMAN, AMANDA (I)
WESLEY, JOHN (I)	BANDEY, PAUL
CARLEY, KURT	WASHINGTON, ROBERT DOUGLAS
GROTE, STEFFIE	ANDERSON, DION (I)
WHITTEMORE, LIBBY	PROBETS, BRYAN
KWONG, PETER (I)	KNEELAND, KATIE (II)
YORKE, TROY	KIRKWOOD, JORDAN
DE BOER, NICOLE	MANTEL, HENRIETTE
OLIVER, NICOLE (I)	ORBACH, JERRY
DOMAN, JOHN	FLYNN, STEVE (III)
MARTINDALE, MARGO	MALONE, PATRICK (I)
DERN, LAURA	RADLEY, XANTHA
LEVANTAL, FRANÁOIS	DEAKINS, SARAH
CHAN, KEE	GAFFNEY, MO
JONES, TAMALA	BORGNINE, ERNEST
BARNES-HOPKINS, BARBARA	NELSON, ADAM (I)
OLSEN, ERIC CHRISTIAN	FANNING, DAKOTA
WINSLET, KATE	SERBEDZIJA, RADE
DEAK, MICHAEL	GILMORE, PATRICK (II)
SIPOS, SHAUN	JORDANOV, DANKO
GLASER, JON	MEADOWS, SAMUEL
WASHINGTON, JASCHA	MCQUAID, KENT
GRUNWALD, ERNIE	JAGLOM, SABRINA
CLARKE, GRAHAM (I)	ASKEW, LUKE (I)
BROWN, JEFFERSON (I)	HOFFMAN, JAKE (I)
MICHAEL, SEAN CAMERON	WILKEY, JIM
DOWNER, WAYNE	SMOLLETT-BELL, JURNEE
PAZ, JENNIFER (I)	BANES, LISA
BELCHER, PATRICIA	BUSH, OWEN (I)
GUNN, PETER (I)	SAUNDERS, KENDALL
KREVOY, CECILE	PAULSON, SARAH
POSTLETHWAITE, PETE	CIBRIAN, EDDIE
WINSTON, HATTIE	PAVLOV, VELISLAV
DUFFY, JACK (II)	KENDALL, KATHERINE (I)
FORRESTALL, SHANNA	BLAISDELL, NESBITT
VOGEL, MIKE (I)	MURPHY, CHARLIE (VIII)
WILLIAMS, BRIAN J.	CASTLE, MAGGIE
DORFF, HOLLY	GAVRIEL, URI
MCCARDIE, BRIAN	PARKER, NATHANIEL
MOSTEL, JOSH	PELDON, ASHLEY
BOYCE, RODGER	DOYLE, KATHLEEN (I)
WALLACE, JACK (I)	MITCHELL, PHILLIP (I)
GUZM·N, LUIS (I)	TRIMBLE, SCOTT
WATSON, WOODY (I)	PHILLIPS, NATHAN (II)
ARGENZIANO, CARMEN	MCCLANAHAN, RUE
LANDRUM, AMBER DAWN	SCANNELL, KEVIN
FALTER, TIM	DEBONIS, MARCIA
WILLIAMS, BILL MARTIN	LIBERTINI, RICHARD
VAN GORKUM, HARRY	DAVIS, ALAN (XIV)
EVIGAN, BRIANA	LABOW, CASEY
MARVEL, ELIZABETH	D'ABO, OLIVIA
CARNEY, D.T.	LONG, MICHAEL R. (I)
MOORE, REGAN	NORTH, DENNIS
CARR, JANE (II)	KOMOROWSKA, LILIANA
MOFFAT, DONALD	ROTH, BRENNA
CORDAY, BILL	ZAPATA, MAYA
ANTHONY, BRYAN (I)	HENDERSON, JOSH (I)
MILLER, BRENDAN (I)	O'LEARY, MATT
FOGERTY, ADAM	SMART, AMY
HAMMOND, ROGER (I)	GIBBON, MARK (I)
HUDSON, PETER (I)	CHAN, TAT-KWONG
CALABRO, THOMAS	WONG, RUSSELL (III)
HANSEN, RYAN (I)	HACKETT, MARTHA
LARSON, BRIE	MARREN, CHRISTOPHER
MCBURNEY, SIMON	RUSSELL, BETSY
BEN BADRA, AFFIF	IVEY, EDITH
EGGERT, NICOLE	KIRZINGER, KEN
WINFREE, RACHEL	THOMPSON, HUGH (II)
HOUGH, ADRIAN	HAWN, GOLDIE
HARRIS, JARED (I)	AZZARA, CANDICE
CIBRIAN, EDDIE	SMULDERS, COBIE
ASSANTE, ARMAND	KEANEY, DERMOT
DINSMORE, BRUCE	VILLA, EDWIN
CANADA, RON	LOPEZ, MARIO (I)
ROBERTS, SEAN O.	LATIFAH, QUEEN
CASTELLANETA, DAN	KAMP, ARIANE VON
NUKE, STEVE	MACANINCH, CAL
JAMES, PELL	FUGIT, LANETTE
CRAWFORD, THOMAS (I)	WAYANS, SHAWN
CHINH, KIEU	ROTH, ELI
ADAMSON, FRANK (I)	LANE, DIANE (I)
KNOWER, ROSEMARY	EMAS, KASEY
ECKHART, AARON	RAMM, HALEY
JAMES, RYAN (II)	PAGE, ANGELICA
BUSH, GEORGE (I)	SHEPHERD, JACK (I)
ZAVAGLIA, RICHARD	FERRERA, AMERICA
WARD, WAYNE (I)	FOX, MEGAN (I)
RIDGELY, ROBERT	JONES, JEFFREY (VIII)
LAURENT, MÈLANIE	TESCH, INGRID (I)
ELLIS, MARK ROBERT	EPPERSON, VAN
OLMOS, EDWARD JAMES	PATRICK, DAN (I)
AKINNUOYE-AGBAJE, ADEWALE	MESTRONI, CARLO
DONARUMA, J.D.	JOHNSON, DAVE (XXVII)
CUCINOTTA, MARIA GRAZIA	JACKSON, STONEY (I)
O'TOOLE, PETER (I)	MOSES, MARK
KOPOLOVICZ, KENNETH	OPPEL, ROBERT
CARLIN, GEORGE	DUELL, WILLIAM
WATSON, KEVIN (I)	HERTFORD, WHIT
YAMAMOTO, DONNA	HARRISON, MICHELLE (II)
GREIGH, BO	BROPHY, BRIAN
KING, MARK (I)	MOORE, REGAN
HERLIHY, TIM	PEARCE, ED (II)
WALLACH, ELI	IENNA, MICHAEL
CAVANAGH, TOM	JEROME, HOWARD
MCGLONE, MICHAEL	HOUSE, DAVID (I)
YUAN, RON	LOWE, CRYSTAL
HARVEY, TERENCE	ABERNATHY, DONZALEIGH
HYDE, JONATHAN (I)	MOORE, KENYA
JOHNSON, MICHELLE (I)	MOORE, MARY TYLER
GOLDBERG, ADAM (I)	HEMSWORTH, CHRIS
EDGERTON, JOEL	BREWSTER, ROBERT (I)
BENNETT, JONATHAN (I)	OTTO, JOHNNY
GREIGH, BO	FIDLER, BRENT
BIGWOOD, JAMES	GOODMAN, CAMERON (I)
OMUNDSON, TIMOTHY	PILATO, JOSEPH
PUSTIL, JEFF	IIZUKA, YOSHIO (I)
GLOVER, JOHN (I)	HIGGINS, JONATHAN
BYNES, AMANDA	ERWIN, MIKE (II)
SKELTON, STEWART	MABE, RICKY
Z'DAR, ROBERT	PETERS, RICK (I)
DORSEY, AARON	XZIBIT
DOUGLAS, SAM (I)	MORATZ, RALPH
YAZPIK, JOSÈ MARÌA	OPAREI, DEOBIA
DURAN, MICKI	PLA, CONRAD
FONG, TIG	SULLIVAN, CAMILLE
BROLIN, JAMES	SMITH, ROGER GUENVEUR
DUKE, DEBORAH	JONES, MICKEY (I)
LEE, SPIKE	METCALF, MARK
REGAN, MIKE J.	SUCHARETZA, MARLA
DENMAN, TONY	PAVLOVSCHI, ADRIAN
STEBBINGS, PETER	WHITLEY, KYM
BUSTER, MICHAEL (II)	CROOK, MACKENZIE
MOYNAHAN, BRIDGET	LEUNG, TONY CHIU WAI
REISER, PAUL (I)	KELLY, LISA ROBIN
BEST, WAYNE (I)	RAY, FRED OLEN
COLE, GARY (I)	GAMMELL, ROBIN
ABELL, TIM	HOWERTON, CHARLES
WELCH, CHRISTOPHER EVAN	YOHNKA, MERRITT
HALL, ANTHONY C.	KIRKPATRICK, BRUCE
WOOD, FRANK (III)	WEISZ, RACHEL
GREENWOOD, BRUCE (I)	GUASTAFERRO, VINCENT
SAMPSON, BRIAN	TAYLOR, PAUL T.
BOREANAZ, DAVID	MCCANN, SEAN (I)
ROMANO, ANDY	SMIGEL, ROBERT
RACK, TOM	Z·RATE, JORGE
LINDE, BETTY	MCDONALD, RYAN (XXVI)
DEWITT, ROSEMARIE	WADDINGTON, STEVEN
BEENE, DAN	STRUFFOLINO, DAVID
JONES, VINNIE	BLANCHETT, CATE
MINA, MINA E.	LINEHAM, HARDEE T.
SHRIMPTON, MARK (I)	BENDER, LAWRENCE
C., WILL	SIEMASZKO, NINA
ROBINSON, CHARLES (I)	BEYER, BRAD
BONJOUR, DANIEL	CANNON, NICK (I)
MAHONEY, TERESA	GORHAM, MEL
BLAISDELL, BRAD	COVERT, ALLEN
WU, PAUL (I)	SUMNER, JOHN (I)
GRANT, SHAUN (I)	BHANEJA, RAOUL
RAILSBACK, STEVE	BURRIS, PETE (I)
ULLMAN, TRACEY	REDMAN, ERICH
HENRY, BUCK	PORTER, SUSIE (I)
GILBORN, STEVEN	TRUMP, DONALD
NERO, FRANCO	OLIVER, JAY (I)
BARRON, DANA	HARRIS, LAURA (II)
RIPPY, MATT	OLDS, GABRIEL
UNDERDUE, TOWANDA	STARR, MARTIN
RAY, FRANKIE (I)	GACHEV, NEVE
PANETTIERE, JANSEN	LANE, JONATHAN (III)
HEBERT, RYAN (I)	BARBER, FRANCES
URBAN, KARL	DELUISE, DAVID
OLDS, GABRIEL	ZIMA, YVONNE
PAULK, MARCUS T.	NIGHY, BILL
CASTRO, MARY	BAIR, JOHN D.
QUINN, J.C.	TAMMI, TOM
JEAN-BAPTISTE, MARIANNE	NAHON, PHILIPPE (I)
MOLINARI, ANTHONY	SMITH, IVAN (I)
MUNIZ, FRANKIE	DETMER, AMANDA
REINER, TRACY	FIELD, TODD
CONNOLLY, DESIREE APRIL	SCHEIDER, ROY
OLSEN, DANIEL (II)	WALTERS, MARK (I)
REMSEN, BERT	STEVENS, DAVID H.
BENSON, PETER (V)	ROBERTS, JEREMY (I)
COMARCHO, MELANIE	ARKIN, ADAM
LOVE, FAIZON (I)	SOTELO, EDDIE 'PIOLIN'
BISHOP, KELLY (I)	JONES, TY (I)
GRAMMER, KELSEY	RICH, ALLAN
JONES, JEDDA	BAHAROV, ZAHARY
HLADY, GREGORY	MCMULLAN, TIM
GUERRA, SAVERIO	HOPE, LESLIE (I)
RITSON, BLAKE	SCOGGIN, NICK (I)
BEALS, JENNIFER	NOGULICH, NATALIJA
VAN, ALEX	WOLF, SCOTT (I)
CHURCH, THOMAS HADEN	WARNER, RICK (I)
ELDARD, RON	MITCHELL, THOMAS (II)
ALLRED, CORBIN	DAVIS, BRIANNE
MAGUIRE, TOBEY	ROBERTSON, BRITT
GREEN, BRIAN AUSTIN	TRAVOLTA, SAM
LEUNG, TONY CHIU WAI	LINKLATER, HAMISH
WALLACE, DON (III)	BELLE, CAMILLA
NICHOLSON, SCOTT (I)	ALLEN, MICHAEL C. 'MIKE'
SCARRY, RICK	ACRES, AVA
BAHAROV, ZAHARY	DUERR, NANCY (I)
BALADI, PATRICK	PROCTOR, TOBY
CAINE, MICHAEL (I)	PARDO, JD
CARROLL, E.J. (II)	CHOWDHRY, RANJIT (I)
ROCHON, LELA	KIERNAN, PAUL (I)
SHEEDY, ALLY	PAQUIN, ANNA
JONES, MICKEY (I)	DWYER, KARYN
TOSAR, LUIS	ZHANG, ZIYI
TAKEUCHI, WARREN	VAN PEEBLES, MARIO
DARLING, JENNIFER (I)	PIZANO, BEATRIZ
WHITE, TREVOR (I)	MARA, KATE (I)
MILONAKIS, ANDY	KIRKLAND, SALLY (I)
HAMILTON, LISAGAY	MACDOWELL, ANDIE
SHUSTER, RICK	AQUINO, AMY
SNAY, TIM	TOM, STEVE (I)
ARMSTRONG, MICHASHA	TAYLOR, WILLIAM S.
CHAET, MARK (I)	BIGHAM, LEXIE
MICHAELS, RHINO	MACY, RICK
AYANNA, CHARLOTTE	RICHARDSON, MIRANDA (I)
POLLAK, KEVIN (I)	SCORSESE, MARTIN (I)
DES BARRES, MICHAEL	SERKIS, ANDY
ROCHON, LELA	PAQUETTE, LOUIS
GOSSETT, ROBERT	O'MALLEY, BINGO (I)
PALLY, ADAM (I)	DELANY, DANA
STEVENS, CONAN	CLINKENBEARD, COLLEEN
WARD, VINCENT M.	SHEEN, RUTH
RAPACE, NOOMI	SIVERTSEN, MARK
MASTROGIORGIO, DANNY	HATFIELD, MERT
HART, STEPHEN R.	OWEN, RENA
HOLNESS, KAREN	LANE, DIANE (I)
MATHESON, HANS	JIMENEZ, CARLA
HAY, AMBER (I)	ADAMS, JULIA (I)
SCHAAP, DAVID	ABECKASER, DANNY A.
MALCOMSON, PAULA	BROWN, W. EARL
ARMENANTE, JILLIAN	EVIGAN, VANESSA
VAN SNELLENBERG, JARED	LOMMEL, ULLI
GUINEE, TIM	WIGHT, PETER
DEAN SR., BENNETT WAYNE	PILL, ALISON
MOORE, LISA BRONWYN	CONROY, BRENDAN
DARBO, PATRIKA	ROBSON, WAYNE (I)
MOORE, DEMI	CHALKE, SARAH
MCCANN, RORY	MULLIGAN, TERRY DAVID
DZUNDZA, GEORGE	CHOW, HO
ANTONUCCI, STEVE	VARGAS, JACOB
BRUSKOTTER, ERIC	JANSEN, JIM (I)
HUGOT, MARCELINE	PAUL, GREG (II)
CHONG, PRECIOUS	SEXTON, LUKE
PENDELTON, CHARLES	WIEBE, CAINAN
BOLOGNA, GABRIEL	DURAND, KEVIN
BERKLEY, ELIZABETH	HENDRIX III, WALTER
SELMOUR, RON	ELENIAK, ERIKA
WALKER, KERRY (I)	JOHNSTON, BOBBY (I)
DEMEO, WILLIAM	CHATHAM, WES
CHONG, TOMMY	CAMP, RICK (I)
MICHAELY, JOEL	HAMILTON, GEORGE (I)
TIERNEY, JACOB	DISKIN, BEN
SCHNARRE, MONIKA	RILEY, TALULAH
TAHAN, CHARLIE	GLASER, JON
CRAWFORD, EVE (I)	CONSTANTINE, YORGO
DURAN, MICKI	FRANKO, VICTOR
MITICHYAN, ROMAN	WHITE, STEVE (I)
ABRAHAMS, DOUG	RUFFO, A. FRANK
ROHR, TONY	WITTING, STEVE
ALTERMAN, STEVE	CAPIZZI, BILL
LAURENT, MÈLANIE	GUYER, MURPHY
LINN, REX	MCGRATH, DOUGLAS
TUPPER, REG	KAY, UNA
BAKER, TROY (II)	HOLLY, LAUREN
TILLY, JENNIFER	KIRZINGER, KEN
LUCAS, SHAUN (III)	RYAN, GER
CAMPBELL, KEITH (I)	POLITO, JON
FLYNN, MICHAEL (I)	DALTON, KRISTEN (I)
KENNEDY, PATRICK (IV)	JONES, TOPHER
LUNDGREN, DOLPH	O'KEEFE, MICHAEL (I)
MOSTEL, JOSH	BINEV, VELIZAR
WOLF, SCOTT (I)	DURAND, CHRIS (I)
ATKINE, FÈODOR	DUNBAR, ALLISON
FURST, STEPHEN	BLACK, JAMES (II)
DEREK, BO	MERCHANT, LARRY
DAVIS, SARAH SCOTT	RAYMONT, DANIEL
DRIESSCHEN, MARKE	ANTHONY, BRYAN (I)
MIARIAUNII, STARLETTE	JACKSON, NEIL (IV)
ROCKET, CHARLES	NOONAN, TOM (I)
SPARROW, DAVID (I)	O'BRIEN, MIKE (XV)
HORAN, JAMES	O'REILLY, CYRIL
PRICE, JUSTIN (III)	LYNN, PHYLLIS
HARVEY, TOM (I)	ANTHONY, LYSETTE
RITSON, BLAKE	CANNON, MATT (II)
KINGI JR., HENRY	MATYSIO, AMY
SCHRADER, KEITH	BUGGY, NIALL
NORMAN, HAYLEY MARIE	BARRY, NINA
NEUHAUS, INGO	PAXTON, BILL
MCCARTHY, DORIS	DOICHINOV, DIMITER
ROSS, VANESSA (III)	SHANNON, MICHAEL (V)
BYNES, AMANDA	ELLIS, GREG (II)
SINGH, GURDEEP (I)	HANMORE, IAN
FISCHER, JOHN LOUIS	POOTS, IMOGEN
SERKIS, ANDY	GITKIN, MATTHEW T.
HANNA, BRYAN (II)	WALSH, M. EMMET
ZYLER, DAVID	BENEDICT, PAUL
MEDRANO, FRANK (I)	AASLAND, DEREK
MILLER, SHERRY (I)	YOUNG, DAMIAN
FOGERTY, ADAM	NERMAN, DAVID
BUZA, GEORGE	RULIN, OLESYA
DENNEHY, NED	CURRY, GRAHAM
COLIN, MARGARET	TENNANT, EMILY
LITTLE RICHARD	BRAUN, NICHOLAS (I)
STARR, BEAU	BULLOCK, SANDRA
MISNER, SUSAN	TULAINE, DIKRAN
DALLIMORE, STEVIE RAY	REICHERT, TANJA
COMBS, JEFFREY	GABAI, RICHARD
BURKE, TOM (IV)	RESSY, DAWN
ARTUS, ASHLEY	DAEHN, WERNER
BLANC, JB	HOFFMAN, LINDA (I)
HOWARD, RON (I)	GRIMES, LUKE
KILLAH, GHOSTFACE	ANGUS, KRISTI
MOSSLEY, ROBIN	HALEY, EMILY D.
ALLEN, KAREN (I)	WALTZ, CHRISTOPH
ANDERSON, DION (I)	HOPKINS, BO
ZAVAGLIA, RICHARD	LEVANTAL, FRANÁOIS
THOMSEN, ULRICH	CLOHESSY, ROBERT
PARRISH, HUNTER (III)	HUTCHINGS, GEOFFREY
LYNN, SHERRY (I)	LUSSIER, SHEILA
LUENELL	CLARKE, CAM
JONES, TAMALA	ARIAS, MOISES
TYSON, CICELY	TUNNEY, ROBIN
GORHAM, MEL	FRANCO, JAMES
WALKER, KERRY (I)	HARPER, HILL (I)
SANDERS, JAY O.	FISCHER, JEFF (I)
BELFI, JORDAN	DANIEL, CHIC
NICKALLS, GRANT	LOWE, CHAD (I)
DIATCHENKO, DIMITRI	MARCANTONIO, JORDAN-PATRICK
COTILLARD, MARION	LEVERT, GARY
LANGEDIJK, JACK	KMIECIAK, SHARYN
DAVIS, PHILIP (I)	LAIDLAW, JACKIE
ALBERTINI DOW, ELLEN	BROWN, DAVID (XXX)
WEBB, DANNY (V)	PEREZ, GUSTAVO (I)
SHANKS, MICHAEL (I)	KURUPT
LEMMY	MOSS, ELISABETH
O'BRIEN, MIKE (XV)	DUGAN, TOM (II)
O'DONNELL, DAVID (I)	SPOSIT, LAURIE
CHRISTENSEN, DAVID (I)	ALBRIGHT, ARIAUNA
JACKSON, NEIL (IV)	HALL, JUSTIN RODGERS
HAYMAN, DAVID (I)	DELUISE, DOM
O'DONNELL, CHRIS (I)	JONES, SAM J. (I)
JAMES, GERALDINE	MCGRATH, DOUGLAS
ESCARPETA, ARLEN	WEITZ, BRUCE
CHRISTENSEN, ALISA	RATHBONE, JACKSON
KEPPER, KENNON	O'GRADY, KATIE
DEARTH, DOUG	WILLIS, BRUCE
JEFFERIES, SYLVIA	DEW, MARTY
GREER, JUDY	HAWTHORNE, NIGEL
DALLIMORE, STEVIE RAY	CLENNON, DAVID
CHOI, KENNETH	QUARRY, ROBERT
SCOTT, JASON-SHANE	BRADY, MOYA
WRIGHT, NATHAN (I)	KENDALL, KATHERINE (I)
WENTWORTH, ALEXANDRA	HU, KELLY
RIVERA, EMILIO (I)	HAUGK, CHARLES
SANDOW, PEGGY	HUNG, SAMMO KAM-BO
THIGPEN, LYNNE	JOYCE, MARK (IV)
CHARTRAND, LAURO	MEARS, DEREK
GERSHON, GINA	HYLANDS, SCOTT
MACKECHNIE, KEITH	KRAMER, CLARE
CLAPP, GORDON (I)	FOREE, KEN
ITTLESON, STEPHANIE	O'DONNELL, KEIR (I)
ENNIS, JOHN (I)	SUTTLES, DARNELL
TOGUNDE, VICTOR	MOORE, JACK (IV)
LOPEZ, PRISCILLA	HARRISON, MICHELLE (II)
BERNARD, AARON (I)	PERKINS, ELIZABETH (I)
BROWNE, BYRON	TALAI, AMIR
SCHIENA, TONY	BOY, BIG (I)
MOORE, JULIANNE	RHYS, MATTHEW
SANTOS, JOE (I)	NUÒEZ, CHRIS (II)
HOLT, SANDRINE (I)	MCCAULEY, JAMES
BLOMMAERT, SUSAN	FOREST, MICHAEL (I)
GAME (I)	DOMAN, JOHN
TUCKER, SEAN (I)	NELSON, ADAM (I)
WEAVER, LEE (II)	RASUK, VICTOR
CARPIO, ANTHONY	HAY, AMBER (I)
BADALUCCO, MICHAEL	SPEIGHT JR., RICHARD
BART, ROGER	MCCULLOUGH, JULIE (I)
PRICE, DAYNA	DENT, CATHERINE
KRESS, DON	LORDS, TRACI
MIDDLETON, KATHRIN	MAPA, ALEC
DOCKY	ACKERMAN, ED (II)
POWELL, COLIN (I)	BACARELLA, MIKE
BRAIDEN, DES	GRAHAM, AIMEE (I)
BELZER, RICHARD	CLEMENS, ADELAIDE
FERGUSON, TOM (I)	RITSON, BLAKE
RIEGERT, PETER	HAMILTON, JOSH (I)
BECERRIL, FERNANDO	BESS, ARDON
MILLAR, GARDINER	DOUGLAS, SARAH (I)
Z˙ÒIGA, JOSÈ (I)	SMITH, BRANDON (I)
DYSON, CHRISTOPHER	HOPKINS, BRUCE (I)
DELL'AGNESE, NORMA	MATARAZZO, HEATHER
EGGLESFIELD, COLIN	FARIS, NASSER
CLANTON, RONY	EICHLING, JAMES 'IKE'
LAWLOR, SEAN	WALLACE, WILL (I)
SCOTT, DAVID W. (I)	HERRERA, ROGER (II)
LAM, SUET (I)	BALABAN, LIANE
HIGDEN, ROBERT	DEAKINS, SARAH
GUERRERO, LISA	ROWLAND, RODNEY
SOUTHWORTH, DAN	IMRIE, KATHY
WEISS, JOEL (I)	CANLAS, VINCE
COSTER-WALDAU, NIKOLAJ	PETRORO, MARISA
RUSSELL, CLIVE	LEVINE, ILANA
BARTLETT, JAMIE (I)	ORBA, KING
BANA, ERIC	BARTLETT, CAL
LAWSON, RICHARD (I)	FRANCIS, ANDREW (I)
RENADAY, PETER	RAVINA, DAX
TAYLOR, RIP	ALEXANDER, JAIMIE
ANDERSON, ANTHONY (I)	GEORGE, JASON (IX)
FABIAN, PATRICK	SCOTT, LEIGH (II)
EDELSON, KENNETH	GRIFFITH, GATTLIN
D., CHUCK	ROBERTSON, KATHLEEN (I)
HINDLE, ART	TAYLOR-JOHNSON, AARON
EBERSOLE, CHRISTINE	ROEMER, SARAH
O'CONNOR, RENÈE	HARTMAN, PHIL (I)
KERSHNER, BASIL	MIHAILOV, VLADO
SARTAIN, GAILARD	O'BRIEN, NIALL (I)
MCGINLEY, TED	MATTHEWS, DAKIN
KAYE, PAUL (IV)	VERZELLO, PIERO
DUKE, DEBORAH	LEA, RON
DUNNE, ROBIN	ROCHÈ, SEBASTIAN
BOYD, CAYDEN	ACHESON, MARK
RUBIO, BRUNA	WRIGHT, JEFFREY (I)
FIELDS, HOLLY (I)	SCHMIDT, MARY ANN (I)
FREDERICKS, DAVID (I)	MARINELLI, SONNY
TAY, SHARON	SPARROW, DAVID (I)
CURTIS, STEVE (I)	GUSTAFSON, GEOFF
TERMATH, STEVE J.	MESKIMEN, JIM
DUELL, WILLIAM	CECERE, FULVIO
NICHOLSON, JULIANNE	CRAMER, GRANT
SENDAYDIEGO, VIVIENNE	HILLE, ANASTASIA
SCOTT, JOHN-CLAY	MEIER, SETH WILLIAM
GORDON, KAREN-EILEEN	OSMENT, EUGENE
COPPOLA, TREVOR	SELDES, MARIAN
SWENSON, ELIZA	JAMES, BRION (I)
GARNER, JULIA	CAMPOS, JAIME H.
KING, DEVON MARIE	HUBAND, DAVID (I)
HOLLEY, BRANDON G.	DÈSERT, ALEX
PADILLA S·NCHEZ, MARISOL	PETERS, ROBERT (I)
GLASCOTT, FIONA	EIGEMAN, CHRIS
LYNCH, KELLY (I)	KURYLENKO, OLGA
HAYS, LAUREN (I)	RI'CHARD, ROBERT
STEUART, JACQUELINE ANN	FAIR, MEL
MOTA, PAUL	HAYDEN, DENNIS (I)
PETERSON, ALAN C.	MARCEAU, SOPHIE
MCALISTER, SCARLETT	LEAL, JACK
WINBUSH, TROY (I)	O'BYRNE, BRÌAN F.
BURKE, MARYLOUISE	GAD, JOSH
MILLER, MARK JEFFREY	MAXWELL, ROBERTA
BYRNES, JIM (I)	KRULL, SUZANNE
FISCHER, DON	PROCHNOW, J¸RGEN
TOWNSEND, STUART (I)	ROSE, GABRIELLE
HUFFMAN, FELICITY	F¸RMANN, BENNO
FRASCA, WILLIAM	HARELIK, MARK
FISHER, CARRIE (I)	NAS
VANDER, MUSETTA	BURGESS, MARK (I)
CARROLL, JUSTIN (I)	FREDERICKS, DAVID (I)
STRICKLAND, KADEE	FALK, PETER (I)
MCCOY, MATT (I)	RUPP, DEBRA JO
O'NEILL, STEVE (I)	FINLEY, CAMERON
MONROE, JARION	LEVINE, SAMM
BLACKBURN, RICHARD (I)	MCHALLEM, CHRIS
COVERT, ALLEN	KIM, DANIEL DAE
COTTET, MIA	BLACK, MICHAEL IAN
BATES, PAUL (I)	MCDOWALL, RODDY
MASON, MADISON (I)	MOORE, MELISSA (I)
MCGETTRICK, TRISH	RICKMAN, ALAN
HEWITT, DON (I)	FINK, JOHN (I)
BENNETT, SONJA	YANNAI, MICHAL
OFFNER, DEBORAH	MURDOCCO, VINCE
MORRISON, JILL (I)	MCDONALD, MICHAEL (XI)
ROACHE, LINUS	BAREIKIS, ARIJA
COLLINS, PAUL (I)	TRIMBLE, JERRY
MELISSIS, TOM	ROBSON, WAYNE (I)
PARKES, GERARD	ESTRELLA, ALBERTO
GILLANE, BILL	FRITZ, NIKKI
BHASKAR, SANJEEV	HOPPER, DENNIS
CORDEN, JAMES (I)	LOW, JASON (I)
CLEMENTS, KYLE RUSSELL	HAMMOND, JOSH (I)
MONKS, MICHAEL (I)	DENCIK, DAVID
DOIG, LEXA	CULLEN, MAX
CAMPBELL, EMMA (I)	SLABAKOV, ANDREY (I)
WHITAKER, DUANE	LIU, YE
BÈART, EMMANUELLE	FOGARTY, SHAWN
SAVINI, TOM	BERKOFF, STEVEN
DAVIS, WILLIAM B.	PHELPS, OLIVER
WARE, TIM (I)	WONG, MICHAEL (I)
RILEY, TALULAH	BUCKLEY, ANDY (II)
TAVERNARO, RICHARD (I)	GUBLER, MATTHEW GRAY
TARANTINA, BRIAN	SOTO, TALISA
UMBERGER, ANDY	KRAMER, KEN (I)
JACKSON, PHILIP (II)	EIGEMAN, CHRIS
COPELAND, JOAN (I)	TIMBER, ROGER J.
SEALY-SMITH, ALISON	GREEN, CURLEY
LYNCH, JOHN (I)	ISHIBASHI, RYO
STARR, MIKE (I)	SALLEY, JOHN
TUNNICLIFFE, GARY J.	YORKER, JADE
TOMEI, MARISA	STEYN, JENNIFER
SCHEELAR, DARRYL	ANZUELO, DAVID
JEFFERIES, MARC JOHN	MCGRATH, MATT (I)
BRAGA, ALICE	NOSSEK, RALPH
FOGARTY, SHAWN	AZARIA, HANK
UMBERGER, ANDY	GILLETT, CHRIS (I)
IRVIN, BRITT	BERG, PETER (I)
WINFREY, OPRAH	FULFORD, CHRISTOPHER
CREWS, TERRY (I)	CHOW, MICHAEL (I)
BITSUI, JEREMIAH	MORGAN, BURKE
HUTCHERSON, JOSH	EGAN, SUSAN
SCIUTTO, NELLIE	DICAPRIO, LEONARDO
THOMPSON, SCOTT (I)	GRAY, CHARLES W.
O'NEILL, STEVE (I)	RIBUSTELLO, ANTHONY J.
HORVITZ, RICHARD STEVEN	MATHEWS, HROTHGAR
REDDY, BRIAN	GAGE, EDWARD JAMES
POPA, RAZVAN	SHATNER, WILLIAM
GOODMAN, CAMERON (I)	CHO, SMITH
HOLLAND, TODD (II)	POPPLEWELL, ANNA
BOWEN, MICHAEL (I)	YORK, KATHLEEN
ASHFIELD, KATE	AKRAM, ADIL
GARLIN, JEFF	KEARIN, STEPHEN
BLACK, GERRY (I)	FISHER, SIMA
BASARABA, GARY	EVERHART, ANGIE
JOSHUA, LARRY	CAREY, PETER (II)
COPELAND, KRISTINA	CHOI, KENNETH
OXENBERG, CATHERINE	YAZPIK, JOSÈ MARÌA
HENDERSON, MARTIN (I)	MARTIN, CHRIS WILLIAM
MILLER, BRENDAN (I)	BEHRENS, YENIFFER
GARRETT, BRAD (I)	ARNOTT, STEWART (I)
VAN PATTEN, JOYCE	GOMEZ, NICK (III)
MONROE, BILL LANGLOIS	MOSSO, JOSEPH
CHEVOLLEAU, RICHARD	DORFMAN, DAVID (I)
BERGERON, PHILIPPE (I)	SOTELO, EDDIE 'PIOLIN'
WILLETT, CHAD	JEWESBURY, EDWARD
SLOTNICK, JOEY	ERICKSON, JULI
JONES, MICKEY (I)	JACKSON, JESSE (I)
RAY, CONNIE (I)	SERNA, PEPE
QUIGLEY, GERRY (I)	BENZ, JULIE
GUILLÈN CUERVO, FERNANDO	KATIC, STANA
KNAPP, ALEXIS	LYNCH, JALIL JAY
MONAGHAN, DOMINIC	CHRISTOPHER, SCOTT (I)
SERBULO, MAYRA	ANDERS, ED
RANDALL, STACIE	PERRY, TYLER (I)
GRIMES, KAREEM J.	GIRARDEAU, FRANK (I)
ALBRIGHT, ARIAUNA	MACLACHLAN, KYLE
OVERSTALL COMFORT, ANN	MOSS, CHRIS (I)
KEARIN, STEPHEN	BROWN, DAVID E. (II)
TAKENAKA, NAOTO	LONGSTREET, ROBERT
DI PRI, TIMOTHY	BUONO, CARA
DYKSTRA, RUSSELL	BENNETT, ZACHARY (I)
O'KEEFE, ED (I)	PLANA, TONY
LAPIRA, LIZA	HINES, TERENCE BERNIE
SCHNEIDER, DAVID (IV)	LAWSON, GREG (I)
RICHARDSON, NATASHA	CHURCHILL, WINSTON (I)
DUERR, NANCY (I)	DINWIDDIE, TRACI
YENQUE, TERESA	SWANK, HILARY
HEYERDAHL, CHRISTOPHER	BESSO, CLAUDIA
COBB, FRANCES	HOLMES, KATIE
ROUILLIER, ROSS	SEACAT, SANDRA
ANTOINE, BENZ	BEKINS, RICHARD
GRUBBS, GARY	PETARDI, RAFAEL
WLASCHIHA, TOM	BRESSLER, CARL
BONILLA, ART	CAMPBELL, ASHLEY LECONTE
VAN WERT, DAN (I)	GASMAN, DAVID (I)
DREGER, REG	COMPTE, MAURICE
OKUMA, ENUKA	VALLETTE, FRANKLIN A.
CLARKE, LARRY	JONES, EVAN (I)
MCKENZIE, TIFFANY SANDER	WILSON, DALE (I)
WILLIAMS, GREGORY ALAN	MOORE, ROGER (I)
HOFFMAN, RICK (I)	DAVIS, JASON (VIII)
STONE, HANK (I)	HEPPELL, COLE
HAGAN, MOLLY	LUDWIG, WALTER (I)
REYNOLDS, MICHAEL J.	SHARIAN, JOHN
DI ZIO, SERGIO	SCHWARTZ, BEN (III)
MOLONEY, JANEL	DYSON, MICHAEL (I)
STONE, TERRENCE (I)	EATON, TAMMY
DIONNE, NICOLE (I)	SO, CLEM
GURRY, KICK	MEIER, SETH WILLIAM
WISEMAN, MICHAEL	MALICK, WENDIE
D, DEEZER	LAMAR, LEON
RAWLS, LOU	SY, OMAR
PAULSEN, MONTGOMERY	TSAROUCHAS, ANGELO
GIANCATERINO, KIM	MARICH, MARIETTA
CHAMBERS, STEVEN (I)	MARSDEN, MATTHEW (I)
CROMWELL, JAMES (I)	MAN, METHOD
SABATINO, JOE	GODON, ERIC
WILCOX, RALPH (I)	INOCIAN, JUNIX
CHINH, KIEU	PIKE, ROSAMUND
DOWD, ANN	OCHMAN, JOE
SALMON, COLIN	CASTELLANOS, VINCENT
VOORHIES, LARK	NOLAN, MICK (I)
PANKOW, JOHN	JEWESBURY, EDWARD
ROTH HABERLE, STEPHANIE	BANKS, LENORE
BARBEAU, ADRIENNE	ARANA, TOMAS
METCALF, LAURIE	DUPLASS, MARK
SCOGGINS, TRACY	MONROE, JARION
HOGAN, CHRIS (II)	LACEY, AARON MICHAEL
LIPNICKI, JONATHAN	REALBA, MIKE
GOMEZ-PRESTON, REAGAN	WILCOX, RALPH (I)
FRENCH, COLBY	SHAIMAN, MARC
LEO, MELISSA (I)	HAMMERSTONE, JOE
CHAN, MAN-CHING	RNIC, PETER
BISSON, JEAN-MARC	MCCOY, MICHAEL (II)
REIM, DONNA GLEE	GEORGE, MELISSA (I)
DUVALL, ROBERT	LIZZI, JOHN
RHEE, LIL	KATZ, CLAUDIA (II)
COX, TONY (I)	IWANONKIW, JOHN W.
TUIASOSOPO, PETER NAVY	DORN, MICHAEL (I)
RNIC, PETER	DIAZ, CAMERON
EPCAR, RICHARD	NAKAMURA, SUZY
KRAUSE, BRIAN (I)	BIBB, LESLIE
EMBREE, JAMES	TOUSSAINT, STEVE
SPIEGEL, SCOTT (I)	BILLINGS, EARL
VAN VILLE, MAX	KEITEL, HARVEY
AYANNA, CHARLOTTE	LARKIN, BOB
FARROW, MIA	SMITH, CAMERON K.
CHATWIN, JUSTIN (I)	PINGUE, JOE
MCINTOSH, YANNA	DILLER, PHYLLIS (I)
FLORENCE, CAROL (I)	GONZALEZ, NICHOLAS (I)
SMITH, RACHELE BROOKE	SKYE, AZURA
CHAN, KIM (I)	STONE, EMMA (III)
MARTINI, MAX	GORDON, EVE (I)
FLYNN, QUINTON	KLANFER, FRANÁOIS
STEWART, THOMAS W.	GISH, ANNABETH
ZAJONC, ROBERT 'BOBBY Z'	HOLLANDER, TOM
WOYTOWICH, WILL	ROBERTS, KEN (VI)
KOPOLOVICZ, KENNETH	LEWIS, GEOFFREY (I)
WARNER, GLEN	MILLER, BEN (II)
TANNER, ANTWON	STELLATE, NICK
BLAISDELL, NESBITT	VARNADO, LAWRENCE
MURPHY, CILLIAN	MURPHY, HARRY S.
RIVAS, JAVIER (III)	SCALES, PRUNELLA
GRAZER, GAVIN	MORGAN, WAYNE DOUGLAS
FREEMAN, ALFONSO	VOIGHT, JON
DREHER, PAGE	HUSSEY, OLIVIA
ROBERTSON, CLIFF (I)	HICKS, BARBARA (I)
FISCELLA, ANDREW	GLEN, IAIN
ANDRIOLE, DAVID	MCGOVERN, BARRY
BOYD, BILLY (I)	TENNEY, JON
D, SKIPPY	BOOTH, LINDY
FLOWER (I)	COSTANZO, ROBERT
STAGGS, MONICA	BELL, ASHLEY (I)
PODELL, EYAL	SARRAZIN, MICHAEL
WHITE, KENNETH (I)	MCINNERNY, TIM
WACHSBERGER, JUSTINE	B-REAL
SANTOS JR., HERB	MARSHALL, PENNY (I)
PALLADINO, ERIK	SIMM, JOHN
NAKAMURA, SUZY	FREEMAN, MORGAN (I)
RAMPLING, CHARLOTTE	WHITE, BERNARD (I)
DIXON, TIM (I)	WYLLIE, DAN (I)
HARRIS, NEIL PATRICK	FAISON, DONALD
HAWE, MACKENZIE	WEST, JOEL (I)
MILLER, SHERRY (I)	HOGAN, HULK
SHIRE, TALIA	YORKER, JADE
MARTINEZ, ANGIE	ARGENZIANO, CARMEN
BLACK, JACK (I)	SUROWIEC, SONNY
DAVIS, ROY MILTON	DANO, PAUL
WARD, ZACK (I)	DALLACE, TOMMY
FAULCONBRIDGE, SCOTT	THURMAN, UMA
BITSUI, JEREMIAH	KOPOLOVICZ, KENNETH
DANIELS, JEFF (I)	SUTCLIFFE, DAVID (I)
BEATON, BRUCE	CLEGHORNE, ELLEN
WOOD, JODY (I)	WRIGHT, AMY (I)
KING, MARTIN LUTHER	PLATT, TARA
WALTERS, SUSAN (I)	ZEGERS, KEVIN
WIRTH, BILLY	MCGRATH, TOM (IV)
ETIENNE, TREVA	GRUNER, OLIVIER
LYNCH, RICHARD (I)	THOMAS, KHLEO
BANKS, ELIZABETH (II)	HALL, ANTHONY C.
CHEN, JOAN (I)	MOLINA, ROLANDO (I)
ORTIZ, JOHN (I)	LEBELL, GENE
ROSE, CHARLIE (II)	THOMPSON, JACK (I)
PROOPS, GREG	PISTOR, LUDGER
HARDMAN, JOHN (II)	FELDMAN, TIBOR
TAYLOR, JAMES ARNOLD	KACZMAREK, CHRISTOPHER
ROSEMONT, ROMY	HALL, LONDON
METAS, CHRISTOPHER	BROWN, BOBBY (I)
SHAW, JOHN (I)	STEWART, ROB (I)
BORLENGHI, MATTHEW	MARTIN, SANDY (I)
STAFFORD, JON	FOX, KERRY (I)
MARKINSON, BRIAN	SIMONINI, RICO
TOUSSAINT, STEVE	SOBIESKI, LEELEE
COX, JENNIFER ELISE	PROCTER, EMILY (I)
ALDA, ALAN	DOAN, JULIE ANN
HALSE, JODY	CLARKE, JEFF (I)
CARNEL, CHRIS (I)	BANES, LISA
PALMER, TERESA (I)	TYSON, RICHARD (I)
DAVIS, VIVEKA	PAQUIN, ANNA
TORRENS, PIP	STUART, JASON (I)
DOUGLAS, TERRI	BEATTY JR., LOU
GIANNONE, JAY	ANDERSON, GILLIAN (I)
PICOY, KANE	DAVIS, EURYDICE
HO, JOSIE	LEVANTAL, FRANÁOIS
BISHOP, KELLY (I)	LAM, SUET (I)
BRADFORD, JAMES (I)	WALLACE, JACK (I)
BLAIR, BILLY (II)	O'NEAL, SHAQUILLE
ROBIE, WENDY	EATON, TAMMY
SAGAL, JOEY	DERN, BRUCE
YASUTAKE, PATTI	BERRYMAN, DOROTHÈE
REMOTTI, REMO	MOSS, TEGAN
DONOHOE, AMANDA	TAYLOR-JOHNSON, AARON
WILCOX, STEVE (I)	CUMPSTY, MICHAEL
BERRY, CHRISTOPHER (I)	JONES, ORLANDO
CHRISTIAN, LUCI	WISE, RAY (I)
GAVRIEL, URI	HODGE, ALDIS
ATKINS, EILEEN	WAITS, TOM
PFEIFFER, MICHELLE	REID, R.D.
CAULFIELD, MAXWELL	BROWN, KEDAR
EMBRY, ETHAN	LANGTON, BROOKE
MIDTHUNDER, DAVID	NAHRGANG, MIKE 'NUG'
PLUNKETT, MARYANN	WINGFIELD, PETER
MCCRARY, DARIUS	KIMBALL, KENT
DI BIANCO, LOUIS	NGUYEN, DEMETRICE
WYNKOOP, CHRISTOPHER	DE SANTIS, TONY
PRYCE, JONATHAN	QUON, DARRYL
CANALS-BARRERA, MARIA	WILSON, PETA
THOMPSON, REECE	BOTET, JAVIER
JOHNSON, DAKOTA	WILLIS, SUSAN (I)
SHUM JR., HARRY	MEWES, JASON
DE ALMEIDA, JOAQUIM	CHABAT, ALAIN
AMICO, ROBERT	DUNLAP, PAMELA
BLADES, RUBÈN	PRESTON, WILLIAM (I)
EVANS, VENIDA	DESANDO, ANTHONY
SMIT-MCPHEE, KODI	SHIELDS, CHRIS (I)
ALEXANDER, ERIKA	PROOPS, GREG
KEAULANA, BRIAN L.	PRUCE, LORNA
PERELLA, MARCO	GIBSON, TYRESE
KINSKI, NASTASSJA	WALKER, EAMONN
WYATT, LISA K.	KEATON, JOSH
INESON, RALPH	PINTO, FREIDA
KEPPER, KENNON	SMITH, MARY JO (I)
WHITMEY, NIGEL	MYLES, SOPHIA
DANIEL, CHIC	HINES, CHERYL
TERRY, JOHN (I)	ATHERTON, TED
ALMGREN, SUSAN	BROCK, BRETT
CORRADO, ALEX	FRENCH, BRUCE (I)
GUERRA, CASTULO	LUND, JAYDEN
ASSBˆCK, JOACHIM PAUL	URY, DAVID
BARNETT, TOM (I)	CAULFIELD, MAXWELL
RAPACE, NOOMI	BEKINS, RICHARD
CERÛN, LAURA	KING, GEORGE (III)
SANDERS, HENRY G.	BYRD, EUGENE
SERRANO, NESTOR (I)	ERMEY, R. LEE
GILMORE, MICKEY	SAVANTE, STELIO
ALLEN, WOODY	BACON, DANIEL (I)
RUSSELL, ROBERT (VIII)	ROCK, SUE (I)
TANNER, RICHARD (I)	REDMOND, SARAH-JANE
HOGAN, FIONA (I)	BOREK, TINA
CAUSIN, JOSEPH RANDY	MARTINS, ANTHONY (II)
CALABRO, NEILL	JARSKY, JORIS
PALMER JR., WILLIAM	MCDONOUGH, NEAL
RIBUSTELLO, ANTHONY J.	GARAI, ROMOLA
CARBONELL, NESTOR	BEDNOB, GERRY
DICK, WILLIAM (I)	KAVANAGH, JOHN (I)
KNUDSEN, ERIK (I)	WINGERT, WALLY
LIEBMAN, SIMONE (I)	UNGER, DEBORAH KARA
JONES, EDDIE (I)	MCINERNEY, BERNIE
FUTTERMAN, NIKA	LOPEZ, PRISCILLA
STREEP, MERYL	NEMETH, VINCENT
GISONDO, SKYLER	CHOUDHURY, SARITA
WILLIAMSON, KATE (I)	BURKLEY, DENNIS
VINCENT, DANIEL (III)	SPEARS, BRITNEY
CARLSON, LESLIE	MIHAILOV, VLADO
DAVIS, SONNY CARL	FERKIN, ELIAS
COTHREN, DUANE	MOBLEY, 'BIG' LEROY
ACOSTA, MONICA (I)	STROUD, DON (I)
KONKLE, TOM	RIECK, BILLY
KEESLAR, MATT	MONROE, JARION
BOSTWICK, BARRY	PETERS, RICK (I)
BON JOVI, JON	MAZURSKY, PAUL
WEST, BILLY (II)	THRELFALL, DAVID
ROMANO, CHRISTY CARLSON	PAGE, ELLEN
KRAYCIK, MICHAEL J.	BLEVINS, RONNIE GENE
DE LA PAZ, DANNY (I)	MUELLER, MAUREEN
ALEXANDER, JAIMIE	SISTO, ROCCO (I)
SCHEELAR, DARRYL	WOODBURN, DANNY
DENHAM, TONY (I)	ABRAMS, PATSY GRADY
SIMMONS, J. NATHAN	MURRAY, KEN (III)
THOMASON, MARK (I)	GARCIA, ERNEST M.
VOSLOO, ARNOLD	BISPING, ALEXANDER
WATKINS, JASON (I)	WALKER, KERRY (I)
DEMITA, JOHN	IRVIN, BRITT
WILLIAMS, HEATHCOTE	PEACOCK, SIMON (I)
GILES, JERRY	GILMORE, ALEXIE
OQUENDO, ANGEL	PERALTO, SASHA
VALDERRAMA, WILMER	MOONEY, NATE
STRONG, DANNY	WILLETT, CHAD
MCBRIDE, CINDY (II)	GUASTAFERRO, VINCENT
BANKS, BOYD	BILLINGSLEY, JOHN (II)
ABBOTT, ANNIE (I)	BEASLEY, MICHAEL (I)
CORRIGAN, BLAISE	BETTENFELD, DOMINIQUE
B-REAL	PATINKIN, MANDY
GREEN, SETH (I)	CARVELL, MARIUM
GILLIARD JR., LAWRENCE	DOUPE, TONY
KEACH, STACY	EDWARDS, SHANNON (I)
GENTCHEV, MAXIM	PARDUE, KIP
KENNY, TOM (I)	SINGER, RACHEL (I)
HEFFNER, KYLE T.	PLEAVIN, ANDREW
LEVINE, SAMM	PROOPS, GREG
BANKS, DEMETRIUS B.	KHEZRI, SLIM
PERRIN, JEANNIE (I)	DODDS FRANK, MARILYN
HARNOS, CHRISTINE	MARSHALL, PAULA (I)
CURTIS, CLIFF	WILHELMINE, OLGA
DANE, LAWRENCE	LEWIS, MELANIE (II)
BABSON, JAMES (I)	KNOWLES, BEYONCÈ
MCCRARY, DARIUS	LANDRUM, AMBER DAWN
MANCINI, JOHN (II)	TRENDAFILOV, ANTON
CRAWFORD, THOMAS (I)	VALLEY, MARK (I)
BANKS, GRALEN BRYANT	LEWIS, RICHARD (II)
CHRISTOPHER, JULIAN	SANCHEZ, VICTORIA (I)
BENING, ANNETTE	ROCKWELL, SAM
RICHARDS, CORDELIA	SHEA, DAN (I)
MCINTOSH, YANNA	CASSIDY, KATIE
LIPINSKI, EUGENE	HERMAN, PAUL (I)
CAULFIELD, MAXWELL	STARK, JONATHAN (II)
SWAIN, DOMINIQUE	BYRD, DAN (I)
BOYD, SEAN (II)	DUNBAR, ROCKMOND
PELLEGRINO, NICK (I)	MASTERSON, MARY STUART
KRESS, DON	COPEMAN, MICHAEL
BRIDGES, BEAU (I)	SEBASTIAN, LOBO
ODOM, GEORGE T.	WILSON, MARK (I)
FRENCH, MICHAEL BRYAN	DEVLIN, ALAN
SUTCHY, SUSANNE	LARA, JOE (I)
HUNTER, RACHEL (I)	CUETO, ESTEBAN (I)
ARTURO, MICHAEL	STEWART, THOMAS W.
EKULONA, SAIDAH ARRIKA	HARDY, ROBERT (I)
TRUMP, DONALD	AMOR, JAY
CROMBIE, PETER (I)	LANGDON, LIBBY
JAY, BARON	PUNCH, LUCY
COMPTON, O'NEAL	STILES, JULIA
STERNE, DAVID	BARRYMORE, DREW (I)
YOUNG, HARRISON (I)	DIAMOND, DUSTIN
MCCARTHY, MAGGIE (I)	WILLIAMS, CYNDA
SESSIONS, JOHN (I)	BIGGS, CHARLOTTE (II)
CATES, GEORGINA (I)	CRANHAM, KENNETH
TEALE, OWEN	SHAWN, WALLACE
CHRISTOPHER, BOJESSE	KENNEY, KERRI (I)
GEER, KEVIN	FRYE, SOLEIL MOON
WOODARD, CHARLAYNE	RICH, GLENDON
SALSEDO, FRANK	FERRERI, MARK J.
THOMPSON, AL (II)	BARUC, SIRI
O'KEEFE, ED (I)	SCHEIDER, ROY
GRANTHAM, RYAN (I)	CARMEN, JULIE
MATTSSON, HELENA	BENEDICT, PAUL
CARTER, MITCH (I)	RITTER, KRYSTEN
WALKER, CRAIG (I)	ADAMS, JULIA (I)
BOEN, EARL	VENTIMIGLIA, JOHN (I)
DITSON, HARRY	OMAN, TIMOTHY
TENNEY, JON	BARKIN, ELLEN
APPLEBY, SHIRI	FREEMAN, PAUL (I)
LEIGH, JENNIFER JASON	ULRICH, SKEET
CALDERON, WILMER	PANCAKE, SAM
HAUER, RUTGER	QUINN, AL (I)
ERICKSON, CHRISTIAN	MURPHY, DONNA (I)
ROACH, MARTIN (I)	BECKER, GERRY
D'ONOFRIO, JOE	NEWMAN, PAUL (I)
HELFER, TRICIA	CAVETT, DICK
JOLIVETTE, VINCE	ANDERSON, PAMELA (I)
FERRARO, JAY	FOX, JAMES (I)
BOLANDER, RICK	IRELAND, MARIN
BEKINS, RICHARD	ANDREWS, DAVID (I)
JACKSON, ROGER (VI)	CHAN, KEE
DEAGAZIO, RICHARD	ORTEGA, JIMMY (I)
BRAZZEL, GREGG	BROOKS, MEL (I)
ABUR, IOANA	CALLAHAN, DAN (I)
PEGG, SIMON	LEONARD, ROBERT SEAN
GALLEGO, GINA (I)	BRASSELLE, MELISSA
KIRKLAND, SALLY (I)	WORTHY, RICK
SIVERTSEN, MARK	ARMSTRONG, BRETT
TODD, ANTONIO LEWIS	MCFARLAND, ERIC KELLY
HAGLER, NIK	BRIDGES, BEAU (I)
DORN, MICHAEL (I)	AYER, DEBBON
DUNARD, DAVID	WIMBUSH, MARTIN
BEASLEY, ALLYCE	SHEEDY, ALLY
FACTORA, MARSHALL	HURLEY, MATTHEW (I)
DREYFUSS, RICHARD	MINNS, BYRON
JOHNSON, GUSTAVE	WILKINS, SHARON
BALDWIN, WILLIAM (I)	OFFERMAN, NICK (I)
MOYO, MASASA	CAVIEZEL, JIM
BARUCHEL, JAY	VALLETTA, AMBER
MACNICOL, PETER	RICHARDSON, FLOYD
POEHLER, AMY	CAVAZOS, LUMI
STAFFORD, JON	KENT, ALLAN
